1111111
1001001
1010001
1c00101
1000001
1000cp1
1000001
1e00001
1111111