11111111111111
10010c000c0011
10100000000001
1c0010000c0011
100000000c0111
1000cp10000001
10010c00010001
1e0000010000c1
11111111111111